WL DMSF Set C2
Baker Street - Gerry Rafferty
All Right Now - Free
Bad Case of Loving You (Doctor, Doctor) - Robert Palmer
Listen to Her Heart - Tom Petty
You Wreck Me - Tom Petty
Tush - ZZ Top
T.N.T. - AC/DC
You Shook Me All Night Long - AC/DC
Long Cool Woman (In a Black Dress) - The Hollies
Footloose - Kenny Loggins
Mustang Sally - Wilson Pickett
Gimme Three Steps - Lynyrd Skynyrd
Pick Up the Pieces - Average White Band
Green River - Creedence Clearwater Revival
Sweet Home Alabama - Lynyrd Skynyrd
Can't You See - The Marshall Tucker Band
Running on Empty - Jackson Browne
Double Vision - Foreigner
You Might Think - The Cars
Little Miss Can't Be Wrong - Spin Doctors
Sharp Dressed Man - ZZ Top
Working for the Weekend - Loverboy
Behind Blue Eyes - The Who
Smooth - Santana featuring Rob Thomas
Honky Tonk Women - The Rolling Stones
I Saw Her Standing There - The Beatles
Surrender - Cheap Trick
Boot Scootin' Boogie - Brooks & Dunn
Fake ID - Big & Rich
